111111111111111
100000000000001
100100000000001
100100000000001
100100000011001
100100000000001
100100000000001
100000000000001
100000000000001
111111111111111

NO textures/tile_000.xpm

SO textures/tile_000.xpm

WE textures/tile_000.xpm

EA textures/tile_000.xpm




